{
  "colliders": [ 18, 40, 16, 16, 16, 16, 16, 18, 40, 84, 15, 16, 84, 15, 16, 16, 15, 16, 16, 12, 37, 16, 16, 58, 12, 37, 16, 16, 18, 40, 16, 16, 15, 16, 16, 15, 16, 16, 16, 16, 16, 12, 37, 16, 16, 16, 16, 15, 16, 16, 16, 15, 16, 16, 16, 84, 15, 16, 16, 12, 37, 16, 16, 15, 16, 16, 16, 16, 16, 15, 16, 16, 16, 16, 16, 84, 15, 16, 16, 16 ],
  "tilemap": [
    [ 9, 9, 9, 9, 9, 9, 18, 40, 85, 85, 16, 16, 16, 16, 85, 16 ],
    [ 9, 22, 9, 9, 9, 9, 9, 18, 40, 85, 85, 85, 85, 85, 85, 85 ],
    [ 9, 84, 9, 9, 9, 9, 9, 9, 15, 85, 85, 85, 85, 85, 16, 85 ],
    [ 9, 9, 9, 22, 9, 9, 84, 9, 15, 85, 85, 85, 85, 85, 16, 16 ],
    [ 9, 9, 9, 9, 9, 9, 9, 9, 15, 85, 85, 85, 85, 16, 85, 16 ],
    [ 9, 22, 9, 9, 9, 9, 9, 12, 37, 85, 85, 16, 85, 85, 85, 16 ],
    [ 9, 9, 58, 9, 22, 9, 12, 37, 85, 16, 85, 85, 85, 85, 85, 16 ],
    [ 25, 25, 25, 25, 26, 9, 18, 40, 85, 85, 85, 85, 85, 85, 16, 16 ],
    [ 28, 28, 28, 28, 29, 9, 9, 15, 85, 85, 85, 16, 85, 85, 85, 16 ],
    [ 31, 31, 31, 31, 32, 9, 9, 15, 85, 16, 85, 16, 85, 16, 16, 16 ],
    [ 9, 9, 9, 9, 9, 9, 12, 37, 85, 85, 16, 16, 85, 85, 16, 16 ],
    [ 9, 22, 9, 9, 9, 9, 15, 85, 16, 85, 85, 85, 16, 85, 85, 16 ],
    [ 9, 9, 9, 9, 22, 9, 15, 85, 16, 16, 85, 85, 16, 85, 85, 85 ],
    [ 9, 9, 84, 9, 9, 9, 15, 85, 85, 16, 16, 85, 85, 85, 85, 85 ],
    [ 9, 9, 9, 9, 9, 12, 37, 85, 85, 85, 85, 85, 16, 85, 85, 16 ],
    [ 9, 9, 9, 9, 9, 15, 85, 16, 85, 16, 85, 85, 16, 85, 16, 16 ],
    [ 9, 9, 9, 9, 9, 15, 85, 16, 16, 85, 85, 85, 16, 16, 16, 85 ],
    [ 22, 9, 9, 84, 9, 15, 85, 16, 85, 85, 85, 85, 16, 16, 85, 85 ]
  ],
  "decomap": [
    [ 26, 27, 28, 0, 0, 0, 0, 0, 0, 0, 0, 0, 0, 0, 0, 0 ],
    [ 29, 30, 31, 0, 0, 26, 27, 28, 0, 0, 0, 0, 0, 0, 0, 0 ],
    [ 0, 0, 0, 0, 0, 29, 30, 31, 0, 0, 0, 0, 0, 0, 0, 0 ],
    [ 0, 0, 0, 0, 0, 0, 0, 0, 0, 0, 0, 0, 0, 0, 0, 0 ],
    [ 0, 0, 0, 0, 0, 0, 0, 0, 0, 0, 0, 0, 0, 0, 0, 0 ],
    [ 0, 0, 1, 0, 0, 0, 0, 0, 0, 0, 0, 0, 0, 0, 0, 0 ],
    [ 0, 0, 0, 0, 0, 0, 0, 0, 0, 0, 0, 0, 0, 0, 0, 0 ],
    [ 0, 0, 0, 0, 0, 0, 0, 0, 0, 0, 0, 0, 0, 0, 0, 0 ],
    [ 0, 0, 0, 0, 0, 0, 0, 0, 0, 0, 0, 0, 0, 0, 0, 0 ],
    [ 0, 0, 0, 0, 0, 0, 0, 0, 0, 0, 0, 0, 0, 0, 0, 0 ],
    [ 0, 0, 0, 0, 0, 0, 0, 0, 0, 0, 0, 0, 0, 0, 0, 0 ],
    [ 0, 26, 27, 28, 0, 0, 0, 0, 0, 0, 0, 0, 0, 0, 0, 0 ],
    [ 0, 29, 30, 31, 0, 0, 0, 0, 0, 0, 0, 0, 0, 0, 0, 0 ],
    [ 0, 0, 0, 0, 0, 0, 0, 0, 0, 0, 0, 0, 0, 0, 0, 0 ],
    [ 0, 0, 0, 0, 0, 0, 0, 0, 0, 0, 0, 0, 0, 0, 0, 0 ],
    [ 0, 0, 26, 27, 28, 0, 0, 0, 0, 0, 0, 0, 0, 0, 0, 0 ],
    [ 0, 0, 29, 30, 31, 0, 0, 0, 0, 0, 0, 0, 0, 0, 0, 0 ],
    [ 0, 0, 0, 0, 0, 0, 0, 0, 0, 0, 0, 0, 0, 0, 0, 0 ]
  ],
  "loading_zones": [
    {
      "zone": [ 0, 8 ],
      "target_level": "demo",
      "target_pos": [ 30, 8 ]
    },
    {
      "zone": [ 0, 7 ],
      "target_level": "demo",
      "target_pos": [ 30, 7 ]
    },
    {
      "zone": [ 0, 9 ],
      "target_level": "demo",
      "target_pos": [ 30, 9 ]
    }
  ],
  "lightmap": [ [ 2, 5 ] ],
  "spawn": [ 0, 0 ],
  "name": "demo2"
}